1111111111111111111111111111111111
1E00000P00P000010000E00000P0000001
101001010010P01E1010010000P0010101
1010010010101011P01001000P000101P1
1P00P000000000000P000P00P00P000PC1
1111111111111111111111111111111111