11111111111111111111
1EEPPPPP000PPPEEEEE1
1ECCCCCCCCCCCCEEEEE1
11111111111111111111